111111111111111111111
133101010001100000001
133000000000100000001
133010101000000000001
111111111001100000001
100000000000000000001
100000000000000111111
100000111111111100001
100000000000000000001
100100000000000001001
100101100000000001011
100100000000000001001
100111111000011111101
100000001000000000001
120000100000000000011
111111111111111111111