111111111111111111111
100000010000000000001
100000010001111000001
100001310000000100001
101001110000000000111
100001000000000000001
100011010000001100001
101000010000000000001
101111110000000001111
100021000000000000001
101111000000010000001
100000000000000000011
101110100010000000101
101000100000000001011
101001100000000010101
101000100000000101011
100011101010101010101
101000000000000000001
111111111111111111111