111111111000000011111
100000000000000000001
100000000000000000001
100000111100000000001
111100010000000000001
100000010000000000001
100001110000000000001
100000010000000000001
111000010000000000001
100000010000000000001
100011110000000131001
100000010000000111001
110000010000000000001
100000010000000000001
100111110101010101011
102000000000000000001
111111111111111111111