111111111111111111111
130000000000000000001
111000000000000000001
111100000000000000001
111111100001111111001
100000000000000000001
100000000000000000011
100111110001111111111
100000000000000000001
110000000000000000001
111111111001111111001
100000000000000000001
100000000000000000011
101111111101111111111
100000000000000000001
110000000000000000001
111000000000000000001
111000100000000000001
111000100010000000001
111000100010001000001
111000000000000000021
111111111111111111111