111111111111111111111
133000000000000000001
111111111111111000001
100000000000000100001
100000000000000010001
100000000000000000011
100000110000000000001
111000000000000000111
100000000000011111111
111000000000000000001
100110000000000000001
100001100000000000001
100000011110000111001
100000000000000000001
100000000000000001101
120000000000000000001
111101100111000111111
100000000000000000001
100000000000000000001
