110000000111111111111
130000000000000000001
111000001100000000001
100000000000000000001
100000000000011000001
100000000000000000001
100000000000000000011
100000000000000000111
100000000011100000001
100000000000000000001
100000001000000000001
100000000000000000001
100000100000000000001
120010000000000000001
111110000000000000001
